%%%%%%%%%%%%%%%%%%%%%%%%%%%%%%%%%%%%%
%                    %P             %
%                    %              %
%                    %%%%%%%%%%     %
%                                   %
%                                   %
%                                   %
%           %%%%%%%%%%%%%%%%%%%     %
%           %                       %
%           %                       %
%           %                       %
%           %                       %
%           %                       %
%           %                       %
%   %%%     %                       %
%   %.%     %                       %
%   %       %                       %
%   %%%%%%%%%                       %
%                                   %
%%%%%%%%%%%%%%%%%%%%%%%%%%%%%%%%%%%%%