%%%%%%%%%%%%%
%.          %
%           %
%          P%
%%%%%%%%%%%%%